WWWWWWWWWWWWWWWWWWWWWWWWWWWWWWWWWWWW
WPPPPPPPPPPPPPPPPPPPPPPPPPPPPPPPPWFW
WWWPWWWWWWWWPWWWWWWWWPWWWWWWWWPWWWPW
WPWPWWPWPPPWPWPPPPWPWPWWPWPWPWPWPWPW
WPWPPPPWPWPWPPPWPPWPWPPWPWPPPWPWPWPW
WPWWWWWWPWWWWWWWWWWPWWPWWWWWWWPWPPPW
WPWPPPPPPPPPPWPPPPPPWPPWPPPPPPPWPWWW
WPPPWWWWWWWWPWWWWWWPWPWWPWWWWWWWPPPW
WWWWWPPPWPPWPPPPPPPPWPPWPWPWPPPPPWPW
WPPPWPWPWWPWPWWWPWWWWWWWPWPWWWWWPWPW
WPWPPPWPPWPWPPPWWWPPPPPPPPPWPPPWPWPW
WPWWWWWWWWPWWWPPPPPWWWWWWWWWPWWWPWPW
WPPPPPPPPPPPPWPWWWWWPPPWPPPPPWPWPWPW
WPWPPWPPPPPWPPPPPWPPPWPPPWPPPPPWPPPW
WPWWWWWPWPWWWWWWWPWWWWWWWWWWWWWWWWPW
WPPPPWPPPWPPWPPPPPPWPPPWPPPWPPPWPPPW
WWWWPWPWPWWWWPWPWWWWPWPWPWPWPWPWPWPW
WPPPPPPWPPPPPPWPPPPPPWPPPWPPPWPPPWPW
WWWWWWWWWWWWWWWWWWWWWWWWWWWWWWWWWWWW