WWWWWWWWWWWWWWW
WPWPPPWPPPWPPPW
WPWPWPWPWPWPWPW
WPWPWPWPWPWPWPW
WPPPWPWPWPWPWPW
WPWPWPPPWPPPWPW
WPWWWWWWWWWPWWW
WPPPPPPWPPPPPPW
WWWWPWPWPWWPWPW
WPPPPWPWPPPPWPW
WWWWWWWWPWWPWPW
WPPPPPPWPWPPPPW
WPWWWWPPPWPWPWW
WPFWPPPWWWPPPWW
WWWWWWWWWWWWWWW