WWWWWWWWWWWWWWW
WPPPPPPPWPPPPPW
WPWWWWWWWPWWWPW
WPWPPPPWPPPPWPW
WPWPWWPWPWWPWPW
WPWPWPPPPWWPWPW
WPWWWWPWWWWPWWW
WPPPPPPWPPPPPPW
WPWPWWPPPWWPWPW
WPWPPWPWPPPPWPW
WPWWWWWWWWWWWPW
WPWPPPPWFWPPPPW
WPWPWWPWPWPWPWW
WPPPWWPWPPPPPWW
WWWWWWWWWWWWWWW