WWWWWWWWWWWWWWWWWWWWWWWWWWWWWWWWWWWW
WPPPWPPPPPPPPPPWPPWPPPPWPPPWPPPWPPPW
WPWPWPPWWWWWPWWWWPWPWPPWPWPWPWPWPWPW
WPWPWWPWPPPWPWPPPPWPWPWWPWPWPWPWPWPW
WPWPPPPWPWPWPPPWPPWPWPPWPWPPPWPWPWPW
WPWWWWWWPWWWWWWWWWWPWWPWWWWWWWPWPWPW
WPWPPPPPPPPPPWPPPPPPWPPWPPPPPPPWPWPW
WPPPWWWWWWWWPWWWWWWPWPWWPWWWWWWWPWPW
WWWWWPPPWPPWPPPPPPPPWPPWPWPPPPPPPWPW
WPPPWPWPWWPWPWWWPWWWWWWWPWPWWWWWWWPW
WPWPPPWPPWPWPPPWWWPPPPPPPPPWPPPPPWPW
WPWWWWWWWWPWWWPPPPPWWWWWWWWWPWWWPWPW
WPPPPPPPWPPPPWPWWWWWPPPWPPPWPWPWPWPW
WPWPPWPPPPPWPPPPPWPPPWPPPWPPPPPPPPPW
WPWWWWWPWWPWWWWWWWWWWWWWWWWWWWWWWWWW
WPPPPWPPPWPPWPPPPPPWPPPWPPPWPPPWPPPW
WWWWPWPWPWWWWPWPWWWWPWPWPWPWPWPWPWPW
WPPPPPPWPPPPPPWPPPPPPWPPPWPPPWPPPWFW
WWWWWWWWWWWWWWWWWWWWWWWWWWWWWWWWWWWW
