WWWWWWWWWWWWWWW
WPWWPPPWWPPPWPW
WPWWPWPWWPWWWPW
WPPPPWPPPPPPWPW
WPWPWWPWPWWPWPW
WPWPWPPPPWWPPPW
WWWWWWPWWWWPWWW
WPPPPPPWPPPPPPW
WPWWPWWWPWWPWPW
WWWPPWPWPPPPWPW
WFWWWWPWPWWWWPW
WPWPWWPWPPPPPPW
WPWPPPPWWWPWPWW
WPPPWWPPPPPWPWW
WWWWWWWWWWWWWWW