WWWWWWWWWWWWWWWWWWWWWWWWWWWWWWWWWWWWWWWWWW
WPPPPPPPWPWPPPPPPPPWPPPPPPPPPPPPWWWWWWWWWW
WPWWWWWPWPWPWPPWPWPWPWPWPWWPWPWWWWWWWWWWFW
WPWPPPPPPPPPWPPWPWPWPWPWPPPPWPPPPPPPPPPPPW
WPWPWPWPWPPPWPPWPWPWPPPWPWWPPPWWWWWWWWWPPW
WPWPWPWPWPPPPPPWPWPWPWWWWWWWWWWPPPPPPPWWWW
WPWPWPWPWPWWWPPPPWPWPWPPPPPPWWWPPPWWWPPPPW
WPWPWPWPWPWPPPWWPWPWPWPPPPPPPPPPPPWPPPWWPW
WPWPPPPPPPWPWWWPPWPWPWWWWWWWWWWWWWWPWWWWPW
WPWPWPWPPPPPWPPPWWPWPPPPPPPPPPPPPPPPWPPPPW
WPWWWWWPPPWWWPWPPWPWWWWWWWWWWWWWWWWPWPPWPW
WPWPPWWWWWWPPPWPWWPWPPPWPPPPPWPPWPPPWPPWPW
WPWPPWPPPPPPWPWPPWPWPWPWPWPPPWPPWPWPWPPWPW
WPWPWWPWWPWWWWWWWWPWPWPPPWPPPWPPPPWPWWWWWW
WPWPPPPWPPPPPPPPPPPWPWWWWWPPPWPPWWWPPPPPPW
WPWWWWWWPWWWWWWWWWWWPWPWPWPPPWWWWPWPWWWWPW
WPPPPPPPPPPPPPPPPPPPPWPWPWPPPPPPPPWPWWWWWW
WWWWWWPWPWWWWWWWWWWWWWPWPWWWWWWWWWWPPPPPPW
WWPPPWPWPWPPPPPPWPPPWWPWPPPPPPWPWPWPPPPPPW
WWPWPWPWPWPPPPPPWPPPPPPPPPPPPPPPPPPPWWWWWW
WWPWPWPWPPPPWWPPWPPPWWWWPWWWWPWPWWWPPWWPPW
WWPWPPPWPWPPWWPPWWWWWPPPPPPPPPWPWPWWPPWPWW
WWPWWWWWPWPPPPPPWPPPWPPWPWWWWPWPWPPWWPPPWW
WWPPPPPPPWPPPWPPPPPPPPWWPWWWWPWPWPWWWWWWWW
WWWWWPWPWWPWWWPWWWWWWWWPPPWWWPWPPPPPPPPWWW
WPPPPPWPWPPPPWPPPWPPPPWPWPWWWPWPPWPPPPPWWW
WPWWWPWPWWWWWWWWPPPPWPWPPPWPPPWPPWPWWWPPPW
WPPPWPWPPPPPPPPPPWPPWPPPWPPPWPWPPWPWPPPWPW
WPPPWWWWWWWWPWWWWWWWWWWWWWWWWWWPPWPWPWPWPW
WPPPPPPPPPPPPPPPPPPPPPPPPPPPPWWPPPPPPPPWPW
WWWWWWWWWWWWWWWWWWWWWWWWWWWWWWWWWWWWWWWWWW