WWWWWWWWWWWWWWWWWWWWWWWWWWWWWWWWWWWWWWWWWW
WPPPPPPPPWPPPPPPPPPWPPPPPPPPWPPPWWWWWWWWWW
WPWWWWWPPWPPWPPWPWPWPWPWPWWPWPWWWWWWWWWWPW
WPWPPWPPPPPPWPPWPWPWPWPWPPPPPPPPPPPPPPPPPW
WPWPPWPWWPPPWPPWPWPPPPPWPWWPPPWWWWWWWWWPPW
WPWPPWPWWPPPPPPWPWPWPWWWWWWWWWWPPPPPPPWWWW
WPWPPWPWWPWWWPPPPWPWPWPPPPPPWWWPPPWWWPPPPW
WPWPPWPWWPWPPPWWPWPWPWPPPPPPPPPPPPWPPPWWPW
WPWPPPPPPPWPWWWPPWPWPWWWWWWWWWWWWWWPWWWWPW
WPWPWPWPPPPPWPPPWWPWPPPPPPPPPPPPPPPPWPPPPW
WPWWWWWPPPWWWPWPPWPWWWWWWWWWWWWWWWWPWPPPPW
WPWPPWWWWWWPPPWPWWPWPPPWPPPWPWPPWPPPWPPPPW
WPWPPWPPPPPPWPWPPWPWPWPWPWPWPWPPWPWPWPPPPW
WPWPWWPWWWWWWWWWWWPWPWPPPWPWPWPPPPWPWWWWWW
WPWPPPPWPPPPPPPWPPPWPWWWWWPPPWPPWWWPPPPPPW
WWWWWWWWPWWWWWWWWWWWPWPWPWPPPWWWWPWPWWWWPW
WPPPPPPPPPPPPPPPPPPPPWPWPWPPPPPPPPWPWWWWWW
WWWWWWPWPWWWWWWWWWWWWWPWPWWWWWWWWWWPPPPPPW
WWPPPWPWPWPPPPPPWPPPWWPPPPPPPPWPWPWPPPPPPW
WWPWPWPWPWPPPPPPWPPPPPPPPPPPPPPPPPPPWWWWWW
WWPWPWPWPPPPWWPPWPPPWWWWPWWWWPWPWWWPPWWPPW
WWPWPPPWPWPPWWPPWWWWWPPPPPPPPPWPWPWWPPWPWW
WWPWWWWWPWPPWWPPWPPPWPPWPWWWWPWPWPPWWPPPWW
WWPPPPPPPWPPPPPPPPPPPPWWPWWWWPWPWPWWWWWWWW
WWWWWPWPWWPWWWPWWWWWWWWPPPWWWPWPPPPPPPPWWW
WPPPPPWPWPPPPWPPPWPPPPWPWPWWWPWPPWPPPPPWWW
WPWWWPWPWWWWWWWWPPPPWPWPPPWPPPWPPWPWWWPPPW
WPPPWPWPPPPPPPPPPWPPWPPPWPPPWPWPPWPWPPPWPW
WPPPWWWWWWWWPWWWWWWWWWWWWWWWWWWPPWPWPWPWPW
WPPPPPPPPPPPPPPPPPPPPPPPPPPPFWWPPPPPPPPWPW
WWWWWWWWWWWWWWWWWWWWWWWWWWWWWWWWWWWWWWWWWW