WWWWWWWWWWWWWWWWWWWWWWWWWWWWWWWWWWWWWWWWWW
WPPPPPPPPPPPPPPPPPPWPPPPPPPPPPPPWWWWWWWWWW
WPWWWWWWWWWPWPPWPWPWPWPWPWWPPPWWWWWWWWWWPW
WPWPPPPPPPPPWPPWPWPWPWPWPPPPPPPPPPPPPPPPPW
WPWPPPPWWPPPWPPWPWPPPPPWPWWPPPWWWWWWWWWPPW
WPWPPPPWWPPPWPPWPWPWPWWWWWWWWWWPPPPPPPWWWW
WPWPPPPWWPWWWPPPPWPWPWPPPPPPWWWPPPWWWPPPPW
WPWPPPPWWPWPPPWWPWPWPWPPPPPPPPPPPPWPPPWWPW
WWWPPPPPWPWPWWWPPWPWPWWWWWWWWWWWWWWPWWWWPW
WPWPWPWPPPPPWPPPWWPWPPPPPPPPPPPPPPPPWPPPPW
WPWWWWWPPPWWWPWPPWPWWWWWWWWWWWWWWWWPWPPPPW
WPWPPWWWWWWPPPWPWWPWPPPWPPPPPWPPWPPPWPPPPW
WPWPPWPPPPPPWPWPPWPWPWPWPWPPPWPPWPWPWPPPPW
WPWPWWPWWPWWWWWWWWPWPWPPPWPPPWPPPPWPWWWWWW
WPWPPPPWPPPPPPPPPPPWPWWWWWPPPWPPWWWPPPPPPW
WPWWWWWWPWWWWWWWWWWWPWPPPWPPPWWWWPWPWWWWPW
WPPPPPPPPPPPPPPPPPPPPWPPPWPPPPPPPPWPWWWWWW
WWWWWWPWPWWWWWWWWWWWWWPPPWWWWWWWWWWPPPPPPW
WWPPPWPWPWPPPPPPWPPPWWPPPPPPPPWPWPWPPPPPPW
WWPWPWPWPWPPWWPPWPPPPPPPPPPPPPPPPPPPWWWWWW
WWPWPWPWPPPPWWPPWPPPWWWWPWWWWPWPWWWPPWWPPW
WWPWPPPWPWPPWWPPWWWWWPPPPPPPPPWPWPWWPPWPWW
WWPWWWWWPWPPPPPPWPPPWPPWPWWWWPWPWPPWWPPPWW
WWPPPPPPPWPPPPPPPPPPPPWWPWWWWPWPWPWWWWWWWW
WWWWWPWPWWPWWWPWWWWWWWWPPPWWWPWPPPPPPPPWWW
WPPPPPWPWPPPPWPPPWPPPPWPWPWWWPWPPWPPPPPWWW
WPWWWPWPWWWWWWWWPPPPWPWPPPWPPPWPPWPWWWPPPW
WPPPWPWPPPPPPPPPPWPPWPPPWPPPWPWPPWPWPPPWPW
WPPPWWWWWWWWPWWPWWPWWWWWWWWWWWWPPWPWPWPWPW
WPPPPPPPPPPPPWWPWWPPPPPPPPPPPWWPPPPPPPPWFW
WWWWWWWWWWWWWWWWWWWWWWWWWWWWWWWWWWWWWWWWWW