WWWWWWWWWWWWWWWWWWWWWWWWWWWWWWWWWWWW
WPPPWPPPPWPPPPPWPPWPPPPWPPPWPPPWPPPW
WWWPWPPWPWWWPWWWWPWPWPPWPWPWPWPWPWPW
WPWPWWPWPPPWPWPPPPWPWPWWPWPWPWPWPWPW
WPPPPPPWPWPPPPPWPPWPWPPWPWPPPWPWPWPW
WPWPWWWWWWWWWWWWWPWPWWPWWWWWWWPWPWPW
WPWPPPPPPPPPPWPPPPPPWPPWPPPPPPPWPWPW
WPPPWWWWWWWWPWWWWWWPWPWWPWWWWWWWPWWW
WWWWWPPPWPPWPPPPPPPPPPWPPWPPPPPPPWFW
WPPPWPWPWWPWPWWWPWWWWWWWPWPWWWWWWWPW
WPWPPPWPPWPWPPPWWWPPPPPPPPPWPPPPPWPW
WPWWWWWWPWPWWWPPPPPWWWWWWWWWPWWWPWPW
WPPPPPPWWWPPPWPWWWWWPPPWPPPWPWPWPWPW
WPWPPWPPPPPWPPPPPWPPPWPPPWPPPPPPPPPW
WPWWPWWPWWWWWWWWPPPWWWWWWWWWWWWWWPWW
WPPWPWPPPWPPWPPPPWPWPPPWPPPWPPPWPPPW
WPWWPWPWPWWPWPWPWWWWPWPWPWPWPWPWPWPW
WPPWPPPWPPPPPPWPPPPPPWPPPWPPPWPWPWPW
WWWWWWWWWWWWWWWWWWWWWWWWWWWWWWWWWWWW